11111111111111111111
10000000000000000001
10100101001000010101
1010010010100001E101
1P0000000C00000000C1
11111111111111111111
