1111111111111111111111111111
1E00000000000000000000000001
101C0C0C0C0C0C0C0C0C0C0C0C01
1010000000000000000000000001
101C0C0C0C0C0C0C0C0C0C0C0C01
1010000000000000000000000001
101C0C0C0C0C0C0C0C0C0C0C0C01
1010000000000000000000000001
101C0C0C0C0C0C0C0C0C0C0C0C01
1010000000000000000000000001
101C0C0C0C0C0C0C0C0C0C0C0C01
1010000000000000000000000001
101C0C0C0C0C0C0C0C0C0C0C0C01
1010000000000000000000000001
1P00C0C0C0C0C0C0C0C0C0C0C0C1
1111111111111111111111111111
