111111
1E0001
101C01
100V01
1P0HC1
111111
