11111111111111111
1E0V0000000000001
1010001C1110100C1
101V000V0C1V111V1
10100C10111010001
101V001V001V111V1
1P0H000H000HC10H1
11111111111111111
