11111
100E1
1C1P1
10C01
11111
