11111111111111111111111111111111
1E0V0000C010000C0000C0000C0000C1
10100C10111010000100001000010001
101V001V001V111VV111VV111VV111V1
10100C10111010000100001000010001
101V001V001V111VV111VV111VV111V1
10100C10111010000100001000010001
101V001V001V111VV111VV111VV111V1
10100C10111010000100001000010001
101V001V001V111VV111VV111VV111V1
10100C10111010000100001000010001
101V001V001V111VV111VV111VV111V1
10100C10111010000100001000010001
101V001V001V111VV111VV111VV111V1
10100C10111010000100001000010001
1P0H000H0C0H011HH011HH011HH011H1
11111111111111111111111111111111
