11111111111111111
1E0V0000001000001
1010001C111010001
101V001V0C1V111V1
10100C10111010001
101V001V001V111V1
1P0H000H0C0H011H1
11111111111111111
