111111
1E0001
101C01
101001
1P00C1
111111
