111111111111111111111
1E0V00000000000000001
1010001C1110100C100C1
101V000V0C1V111V111V1
10100C101110100010001
101V000V0C1V111V111V1
10100C101110100010001
101V000V0C1V111V111V1
10100C101110100010001
101V001V001V111V111V1
1P0H000H000HC10HC10H1
111111111111111111111
