11111111111111111111111111111111
1EHV0H00C010000C00H0C00H0C0000C1
10100C10111010000100001000010001
10100010001011100111001110011101
10100C10111010000100V010000100V1
10100010001011100111001110011101
10100C10111010000100001000010001
101V0010001011100111001110011101
10100C1011101000010000100V010001
1010001000101110V111001110011101
10100C10111010000100001000010001
10100010001011100111001110011101
10100C10111010000100001000010001
1010001V001011100111001110011101
10100C10111010000100001000010001
1P0H000H0C0H011H00110H0110H011H1
11111111111111111111111111111111
