111111
1E00C1
101C01
1010C1
1P0C01
111111
