111111
1EH001
101C01
100V01
1P0HC1
111111
