111111111111111111
10C00000CC00000CP1
101000001100000101
101100001100001101
101010001100010101
101011001100110101
101001001100100101
101001001100100101
101011001100110101
101010011110010101
101110010010011101
101011010010110101
101001110011100101
101000101101000101
101000101101000101
101111111111111101
100000101101000001
100000011110000001
100000001100000001
1E0000000000000001
111111111111111111
