111111
1E0001
1010C1
101001
1P00E1
111111
