111111
1E0001
101C01
101001
1000C1
111111
