111111
1E001
101C1
10101
1P001
111111
