111111
1E0001
101C01
101I01
1P00C1
111111
