111111
1E0001
101C00
101001
1P00C1
111111
