111111
1E0001
101C01
101011
1P01C1
111111
