111111111111111111
1E0V00000000000001
1010001C11101100C1
101000000C1V1111V1
10100C10111010H001
1010001V001011C101
1P0H0000000HC00001
111111111111111111
