11111111111111111111111111111111
1P0000000C000000H00000000C000001
10111C11011110111110111101111011
101000010C0000010000010000010101
1V000C0H0010001000H00C000000H001
101110110111C101111C110111110101
10100001V000000100000C000H01V1C1
101011C1011101010111V10111010111
1010H0010100000H01010001C1000101
10101111010111011101001101011101
101000010C000001C000H1000H000101
1V101111101111V111111011111011V1
101V00010100000000C1C00101000101
101011110101110101011V01011C0101
101011110111110111111011111101E1
1C0000000H00000000000H0C00000001
11111111111111111111111111111111
